meter	meter
metre	meter
second	sekonde
ampere	amp√®re
kelvin	kelvin
candela	kandela
mole	mol
hertz	hertz
radian	radiaal
steradian	steradiaal
newton	newton
pascal	pascal
joule	joule
watt	watt
coulomb	coulomb
volt	volt
farad	farad
ohm	ohm
siemens	siemens
weber	weber
tesla	tesla
henry	henry
degree celsius	graad celsius
degree	graad
lumen	lumen
lux	lux
becquerel	becquerel
gray	gray
sievert	sievert
katal	katal
kilometer per hour	kilometer per uur
newton meter	newtonmeter
meter per second	meter per sekonde
minute	minuut
hour	uur
day	dag
week	week
month	maand
year	jaar
century	eeu
millenium	millennium
inch	duim
foot	voet
yard	jaart
chain	ketting
furlong	furlong
mile	myl
league	liga
fathom	vadem
cable	kabellengte
nautical mile	seemyl
link	skakel
rod	roede
rood	roede
acre	akker
square mile	vierkante myl
fluid ounce	vloeistofons
gill	gill
pint	pint
quart	kwart
gallon	gelling
ounce	ons
pound	pond
stone	stone
hundredweight	honderdgewig
ton	ton
pixel	pixel
pixel per inch	pixel per duim
cubic centimeter	c_letter c_letter
cc	c_letter c_letter
degree	graad
hectare	hektaar
liter	liter
tonne	ton
neper	neper
bel	bel
gram	gram
smoot	smoot
degree	graad
minute	minuut
second	sekonde
decibel	desibel
electron volt	elektronvolt
dalton	dalton
knot	knoop
are	are
barn	barn
bar	bar
atmosphere	atmosfeer
horsepower	p_letter k_letter
degree fahrenheit	graad fahrenheit
tablespoon	eetlepel
teaspoon	teelepel
revolution	omwenteling
revolution per minute	omwenteling per minuut
mile per hour	myl per uur
barrel	vat
barrel per day	vat per dag
barrel of oil	vat olie
barrel of oil per day	vat olie per dag
barrel of oil equivalent	b_letter o_letter e_letter
barrel of oil equivalent per day	b_letter o_letter e_letter per dag
bit per second	bit per sekonde
bit	bit
byte per second  greep per sekonde
byte	greep
light year	ligjaar
kilogram-force	kilogramkrag
kilogram force	kilogramkrag
calorie	kalorie
kilocalorie	kilokalorie
piece	stuk
astronomical unit	astronomiese eenheidd
square	vierkante
cubic	kubieke
percent	procent
north	noord
south	suid
east	oos
west	wes
day	dag
blz	bladsy
